GOSPEL ASF Organizational Hierarchy
	1. ASF Air Command - commands all air forces
	2. ASF Lance Air Command - air division equivalent
	3. ASF Wing - wing equivalent
	4. ASF Lance Wing - squadron equivalent
	5. ASF Flight - flight equivalent
	6. ASF Lance Flight - element equivalent 
GOSPEL ASF Rank Hierarchy
	ASF Command Officers - expected to manage administration and high level strategic planning
	1. ASF Marshal - heads an Air Command
	2. ASF Lance Marshal - heads a Lance Air Command
	3. ASF Wing Colonel - heads a Wing, typically base commander

	ASF Flight Officers - expected to manage low level strategic planning and lead air forces in combat
	4. ASF Lance Wing Colonel - heads a Lance Wing
	5. ASF Flight Major - heads a Flight
	6. ASF Lance Flight Major - heads a Lance Flight
	
	ASF Combat Officers - expected to manage low level administration and fly combat missions 
	7. ASF Lieutenant - serves as secondary leader of a Lance Flight, and leader of non-flying units
	8. ASF Lance Lieutenant - pilots aerospace craft, serves as secondary leader of non-flying units

	9. ASF Wing Sergeant
	10. ASF Lance Wing Sergeant
	11. ASF Flight Sergeant
	12. ASF Lance Flight Sergeant
	13. ASF Flight Trooper
GOSPEL SCCF Organizational Hierarchy
	1. SCCF Sea Command - commands entire navy
	2. SCCF Lance Sea Command - front/region
	3. SCCF Fleet - battle fleet equivalent
	4. SCCF Lance Fleet - task force equivalent
	5. SCCF Division - task group equivalent
	6. SCCF Lance Division - squadron equivalent
GOSPEL SCCF Rank Hierarchy
	1. SCCF Command Admiral - heads Sea Command
	2. SCCF Lance Command Admiral - heads Lance Sea Command
	3. SCCF Admiral - heads Fleet
	4. SCCF Lance Admiral - heads Lance Fleet
	5. SCCF Command Captain - heads Division
	6. SCCF Lance Command Captain - heads Lance Division

	SCCF Ship Officers - expected to be responsible for the ship under their command
	7. SCCF Captain - heads a single large/capital ship
	8. SCCF Lance Captain - heads a single medium ship
	9. SCCF Commander - heads a single small ship
	10. SCCF Lance Commander - heads a single auxiliary ship

	11. SCCF Fleet Petty Officer
	12. SCCF Lance Fleet Petty Officer
	13. SCCF Petty Officer
	14. SCCF Lance Petty Officer
	15. SCCF Fleet Trooper
GOSPEL ATVAF Organizational Hierarchy
	1. ATVAF Storm Command - commands entire marine force
	2. ATVAF Lance Storm Command - equivalent front/region
	3. ATVAF Legion - equivalent to division
	4. ATVAF Lance Legion - equivalent to regiment
	5. ATVAF Battalion - equivalent to battalion
	6. ATVAF Lance Battalion - equivalent to company
	7. ATVAF Platoon - equivalent to platoon
	8. ATVAF Lance Platoon - equivalent to squad
GOSPEL ATVAF Rank Hierarchy
	1. ATVAF Praetor - heads Storm Command
	2. ATVAF Lance Praetor - heads Lance Storm Command
	3. ATVAF Legate - heads Legion
	4. ATVAF Lance Legate - heads Lance Legion
	5. ATVAF Centurion - heads Battalion
	6. ATVAF Lance Centurion - heads Lance Battalion
	
	7. ATVAF Prefect - Senior NCO, provides advisory command to Lance Storm Command and up
	8. ATVAF Lance Prefect - Senior NCO, provides advisory command to Lance Legion and up
	9. ATVAF Praetorian - Senior NCO, provides advisory command to Lance Battalion and up OR serves as honor guard leader
	10. ATVAF Lance Praetorian - Senior NCO, serves as Platoon sergeant OR honor guard
	11. ATVAF Decurion - NCO, heads a Lance Platoon
	12. ATVAF Lance Decurion - NCO, assists a Decurion (especially if the unit needs to split up)
	13. ATVAF Legionnaire - basic soldier
GOSPEL SASF Organizational Hierarchy
	1. SASF Void Command - commands all space navy forces
	2. SASF Lance Void Command - equivalent to front
	3. SASF Support Fleet - equivalent to battle fleet
	4. SASF Lance Support Fleet - equivalent to task force
	5. SASF Squadron - equivalent to flotilla
	6. SASF Lance Squadron - equivalent to squadron
GOSPEL SASF Rank Hierarchy
	1. SASF Command Commodore - heads Void Command 
	2. SASF Lance Command Commodore - heads Lance Void Command
	3. SASF Commodore - heads Support Fleet
	4. SASF Lance Commodore - heads Lance Support Fleet
	5. SASF Auxiliary Commodore - heads Squadron
	6. SASF Lance Auxiliary Commodore - heads Lance Squadron

	7. SASF Commander - heads large ships(carriers/light cruisers)
	8. SASF Lance Commander - heads non-large ships, on larger ships leads departments

	9. SASF Fleet Sergeant - Senior NCO, coordinates divisions/leads departments
	10. SASF Auxiliary Sergeant - NCO, coordinates teams, typically 2nd in command for departments or command for divisions
	11. SASF Auxiliary - NCO, commands teams of Lance Auxilaries in their duties
	12. SASF Lance Auxiliary - basic trooper
GOSPEL SSOP Rank Hierarchy
	1. Command Deacon - heads entire chaplain force
	2. Lance Command Deacon - heads regional chaplain force
	3. Deacon - religious advisor to Command
	4. Lance Deacon - religious advisor to Lance Commands
	5. Chaplain - religious advisor to Lance Corps and up
	6. Lance Chaplain - religious advisor to Lance Regiment and up

Definitions
	GOSPEL - Guardians Of Sacred Peace: Earth Lance
		Human military forces serving the Aliens
	Lance - For command/organization is essentially equivalent to 'lesser'
		For NCO/Enlisted refers to units with training in specialist/support equipment
	CivilLog - Civil Relations & Logistics, support staff focused on improving relations with civilians and using both civilian and military assets
		to transport and manage unit logistics
Notes
	GOSPEL Ground Control Force (GCF) - GOSPEL's Army, uses infantry, mechanized, cavalry, artillery, and armor forces to maintain territorial control
	GOSPEL Aerospace Superiority Force (ASF) - GOSPEL's Air Force, uses aerospace fighters, bombers, transports, and surveillance to maintain aerospace superiority and disrupt enemy logistics
	GOSPEL Sea Command and Control Force (SCCF) - GOSPEL's Aquatic Navy, uses carriers, destroyers, cruisers, battleships, submarines, frigates, and patrol boats to ensure control and safety of the sea
	GOSPEL All Terrain Vanguard Assault Force (ATVAF) - GOSPEL's Marines, uses drop pods, infantry, heavy infantry, and other rapid assault forces to quickly take/destroy enemy installations, forming a beachead for other forces to control
		Even the most basic ATVAF troops are highly trained, thus they tend to get more freedom than the other branches
		Their ranks speak to their elitism as they purposefully made their names more obtuse for non-ATVAF personnel
	GOSPEL Space Action Support Force (SASF) - GOSPEL's Space Navy, uses frigates, corvettes, destroyers, and light cruisers to project space control and provide fire support
	GOSPEL Sacred Special Operations Practioners (SSOP) - GOSPEL's chaplain/priests, have a seperate rank structure but are primarily deployed as part of other branches
Trooper Designation
AAAAA-0-A 00 0 0 0 0 0-00
Planet-BranchNumber-UnitType TwoDigitCorpsHexNumber RegimentHexNumber BattalionHexNumber CompanyHexNumber PlatoonHexNumber SquadHexNumber-TrooperHexNumber
ex. EARTH-1-I09A4256-0C
Earth GCF 9th Infantry Corps, 10th Regiment, 4th Lance Regiment, 2nd Company, 5th Platoon, 6th Squad, 12th Trooper